NO ./textures/MARBFAC2.xpm   	
SO ./textures/MARBFAC3.xpm
WE ./textures/MARBFACE.xpm
EA ./textures/MARBLE1.xpm

F  255,100,255  
C  255,255,255	


1111
10N1
1110