1111111111111111111111111
1000000000110000000000001
1011000001110000000000000                                                     1
1001000000000000000000001
1011000001110000000000001
1000000000110000011101111
1111011111111111110000001
1111011111111111110101001
1100000011010101110000001
1000000000000000110000001                  1
1000000000000000110101001
1100000011010101111101111                                        1
1111011111110111111101111
1111011111110010110000001
1100000111000000110000001
1000000011000000110000001
1000000011111110111000101                           1
1000000011111111111101001
1100000111000111111000111             1
1000000010000011010101001
1000000000000000000000001
1000000010000011010101001
1100000111000111111000111
11000001110001111110N0111
1111111111111111111111111