NO ./textures/MARBFAC2.xpm   	
SO ./textures/MARBFAC3.xpm
WE ./textures/MARBFACE.xpm
EA ./textures/MARBLE1.xpm

F  255,100,255  
C  255,255,255	

          1111111111
          1000000001  
          1011000001
          1001000001
11111111111111111111
